{
    "start": {
        "tileset": "field",
        "content": [
            [0, 24, 25, 26, 27, 0, 0, 0, 0, 0, 0, 0, 0, 0, 0, 0],
            [0, 44, 45, 46, 47, 0, 0, 0, 2, 0, 0, 0, 0, 0, 0, 0],
            [0, 84, 85, 86, 87, 0, 0, 0, 0, 0, 0, 24, 25, 27, 0, 0],
            [0, 0, 2, 0, 0, 0, 0, 0, 0, 0, 0, 44, 45, 47, 0, 0],
            [0, 0, 20, 21, 22, 21, 23, 0, 0, 0, 0, 84, 85, 87, 0, 0],
            [0, 0, 40, 41, 42, 41, 43, 0, 3, 0, 0, 0, 0, 0, 0, 0],
            [0, 0, 60, 61, 62, 61, 63, 0, 0, 0, 0, 0, 0, 0, 0, 0],
            [0, 0, 60, 61, 62, 61, 63, 0, 0, 0, 0, 0, 0, 0, 0, 0],
            [0, 0, 60, 61, 62, 61, 63, 0, 0, 0, 0, 0, 0, 0, 0, 0],
            [0, 0, 60, 61, 62, 61, 63, 0, 0, 0, 0, 0, 0, 0, 0, 0],
            [0, 0, 80, 81, 82, 81, 83, 0, 0, 0, 0, 0, 0, 0, 0, 0],
            [0, 0, 0, 0, 0, 0, 0, 0, 0, 0, 0, 0, 0, 0, 0, 0],
            [0, 0, 0, 0, 0, 0, 0, 0, 0, 0, 0, 0, 0, 0, 0, 0]
        ]
    }
}